HIGHSCORE=Hi-Score
SCORE=Score
LIVES=Lives
BOMBS=Spellcard
PIECES=(pieces)
POWER=Power
VALUE=Value
GRAZE=Graze
SPELLBONUS=Got Spell Card Bonus!
BONUSFAILED=Bonus Failed...
TICKTIME=Time Taken:
SECONDSTIME=Actual Time:
SLOWDOWN=Slowdown:
GAMESTART=Game Start
EXTRASTART=Extra Start
PRACTICE=Practice
MUSIC=Music Room
REPLAY=Replay
PLAYERDATA=Player Data
OPTIONS=Options
QUIT=Quit Game
PAUSED=Game Paused
RESUME=Resume Game
RESTART=Restart Game
RETURNTOTITLE=Return To Title
EASY=Easy Difficulty
NORMAL=Normal Difficulty
HARD=Hard Difficulty
LUNATIC=Lunatic Difficulty
SPELLCARD1=stupid shaders never work
SPELLCARD2=test 1 2 3 is this on?
SPELLCARD3=blue fire is hotter than red